7 15
###############
#...#.P.B.#...#
#.#...###...#.#
#.#.#D...R#.#.#
#.#.###.###.#.#
#$.....A.....*#
###############
RLDD
4 1 1 5 1 5 13 1 13
UUURDDDL

