7 15
###############
#.........##.*#
#.####.##P.D.##
#A..$#....##..#
#.####.##B.R.##
#.........##.*#
###############
UDRR
2 3 4 3 12
UDLRRLDU

