9 11
###########
#P.......B#
#.###*###.#
#.#D...R#.#
#$..###...#
#.#..A..#.#
#.###.###.#
#....$...*#
###########
UULR
4 1 1 8 10 8 1 1 10
UUDDLRLR

